13 13
#############
#   L   L   #
# s L P L s #
#   L   L   #
#       L   #
#   LLLLL   #
#           #
#     b     #
#           #
#     W     #
#  b        #
#        b  #
#############
